"filename", "language", "JavaScript", "comment", "blank", "total"
"/media/chirag/DATA/CODE_AMA/dass/assignment 1/backend/app.js", "JavaScript", 2, 0, -1, 1
"/media/chirag/DATA/CODE_AMA/dass/assignment 1/backend/controllers/post.js", "JavaScript", 74, 7, 7, 88
"/media/chirag/DATA/CODE_AMA/dass/assignment 1/backend/controllers/report.js", "JavaScript", 38, 0, 0, 38
"/media/chirag/DATA/CODE_AMA/dass/assignment 1/backend/controllers/subgreddit.js", "JavaScript", 119, 9, 2, 130
"/media/chirag/DATA/CODE_AMA/dass/assignment 1/backend/controllers/test.js", "JavaScript", 14, 0, 3, 17
"/media/chirag/DATA/CODE_AMA/dass/assignment 1/backend/controllers/user.js", "JavaScript", 98, 3, 4, 105
"/media/chirag/DATA/CODE_AMA/dass/assignment 1/backend/middleware/authentication.js", "JavaScript", 1, 3, 0, 4
"/media/chirag/DATA/CODE_AMA/dass/assignment 1/backend/middleware/error-handler.js", "JavaScript", 0, 1, -1, 0
"/media/chirag/DATA/CODE_AMA/dass/assignment 1/backend/models/Post.js", "JavaScript", 14, 0, 0, 14
"/media/chirag/DATA/CODE_AMA/dass/assignment 1/backend/models/SubGreddit.js", "JavaScript", 2, 0, 0, 2
"/media/chirag/DATA/CODE_AMA/dass/assignment 1/backend/models/User.js", "JavaScript", 1, 0, 0, 1
"/media/chirag/DATA/CODE_AMA/dass/assignment 1/backend/routes/post.js", "JavaScript", 10, 0, 0, 10
"/media/chirag/DATA/CODE_AMA/dass/assignment 1/backend/routes/report.js", "JavaScript", 2, 0, 0, 2
"/media/chirag/DATA/CODE_AMA/dass/assignment 1/backend/routes/subgreddit.js", "JavaScript", 7, 0, 0, 7
"/media/chirag/DATA/CODE_AMA/dass/assignment 1/backend/routes/user.js", "JavaScript", 6, 0, 0, 6
"Total", "-", 388, 23, 14, 425