"filename", "language", "JavaScript", "comment", "blank", "total"
"/media/chirag/DATA/CODE_AMA/dass/assignment 1/backend/app.js", "JavaScript", 2, 0, 0, 2
"/media/chirag/DATA/CODE_AMA/dass/assignment 1/backend/controllers/post.js", "JavaScript", 54, 0, 1, 55
"/media/chirag/DATA/CODE_AMA/dass/assignment 1/backend/controllers/report.js", "JavaScript", 66, 0, 3, 69
"/media/chirag/DATA/CODE_AMA/dass/assignment 1/backend/controllers/subgreddit.js", "JavaScript", 1, 0, 0, 1
"/media/chirag/DATA/CODE_AMA/dass/assignment 1/backend/models/Post.js", "JavaScript", -6, 0, 0, -6
"/media/chirag/DATA/CODE_AMA/dass/assignment 1/backend/models/Report.js", "JavaScript", 13, 0, 0, 13
"/media/chirag/DATA/CODE_AMA/dass/assignment 1/backend/models/SubGreddit.js", "JavaScript", 1, 0, 0, 1
"/media/chirag/DATA/CODE_AMA/dass/assignment 1/backend/routes/post.js", "JavaScript", 1, 0, 0, 1
"/media/chirag/DATA/CODE_AMA/dass/assignment 1/backend/routes/report.js", "JavaScript", 6, 0, 4, 10
"Total", "-", 138, 0, 8, 146